3100322000
3000222000
3000220001
0000000011
1000000011
0000000033
0000000000
3000000000
0330000000
3300333000

